######################################## 
#...........#.........................##
#..#..#..#..#..####?--#####..######...##
#..#..#..#..#..#..........#..|....#...##
#...........#..#...####...#..?....|...##
#..#..#..#..|..#..######..#..#.##.?...##
#..#..#..#..|..#..######..#..######...##
#...........?..#...####...#..##..##...##
#..#..#..#..#..#..........#..##..#?...##
#..#..#..#..#..####?--#####..|....|...##
#...........#................?..###...##
##-----##-####?-#####?-####?-######...##
##.........##.....##......##...####...##
##..#####..##.@...#.......###.*.###...##
##..#####..#?.##?.#..####..#.#..###...##
#*........*########..####..##.#..##....!
###############*..#.......##############
########################################
